[
------------------------------------------------------------------------------------|
-               *                    ***                              P            -|
-             *         *            ***                                          --|
----                    *--**        ***                                        ----|
-            --                     -NNNSS        -----                        -----|
-                                  -NNNNNN********                        -***------|
-                                 -NNNNNN-                    **--                 -|
-         SSSd                   -----NNN-                                         -|
--                   -**-            -NNN-      ***                                -|
-                                --*-NNNN-     -----               ****            -|
--                                  *NNNN-     ****                        *****   -|
-       **                          *NNNN-                                         -|
-          -----------------------------------------------SSS----          -    -- -|
-                                   *NNNN-                               ---**--   -|
-                                   *NNNN-                                         -|
-      ---                          *NNNN-                   -----            **** -|
-                     R             *NNNN-         ---------             SSSSS     -|
-   --------  *     ----            *---------                                     -|
-                                           ------                                 -|
-                         -                     -N*                                -|
-      **                    --     *-------    ------------                       -|
-      *                            *NNNNNN-    ****                               -|
-     **                            *NNNNNN-    ****      R        R               -|
---------------   ***        --------NNNNNN-    ****  --------                     -|
-                            -      *NNNNNN-    ****                ---           --|
-                  --       -       *NNNNNN-    ****      **  ------               -|
-                  --       -       *NNNNNN-    **** ---                           -|
-                  --       -       *NNNNNN-   *****                               -|
-                  --       -       *NNNNNN-    ****        ---              **    -|
-                  --       -       *--  ---    ****                 R--           -|
-                  --               *--  ---*   ****                               -|
-                                   *--  --*    ****                             ---|
-                                   *--  --*    ****                               -|
-                                   *--         ****                               -|
-                                   *NN----*    ****                               -|
-                                   *NNNNNn*    ****                               -|
-                                   *NNNNNN*    ****                               -|
-                                   *NNNNNN*                                       -|
-                                   *NNNNNN---------JSJSJSJSJSJSJSJSJSJSJSJSJSJSJSJ-|
-                           --------NNNNNNNNNNNNNNNNNNNNNNNNNNNNNNNNNNNNNNNNNNNNNNNN|
----------------------SSSSS-NNNNNNNNNNNNNNNNNNNNNNNNNNNNNNNNNNNNNNNNNNNNNNNNNNNNNNNN|
]
player 55 44 4 7

monster 190 250 3 1 1000 1000

monster 450 430 3 5 1000 1000

monster 160 230 3 2 1000 1000


/